"filename", "language", "C#", "ShaderLab", "comment", "blank", "total"
"/Users/kami/UnityProjects/Sweet-Bedtime-O-Mine/Assets/Scripts/Audio/AudioManager.cs", "C#", 45, 0, 0, 10, 55
"/Users/kami/UnityProjects/Sweet-Bedtime-O-Mine/Assets/Scripts/Bonus/Bonus.cs", "C#", 58, 0, 0, 9, 67
"/Users/kami/UnityProjects/Sweet-Bedtime-O-Mine/Assets/Scripts/Bonus/BonusData.cs", "C#", 10, 0, 0, 2, 12
"/Users/kami/UnityProjects/Sweet-Bedtime-O-Mine/Assets/Scripts/Boss/BossManager.cs", "C#", 18, 0, 4, 5, 27
"/Users/kami/UnityProjects/Sweet-Bedtime-O-Mine/Assets/Scripts/Boss/ClockQueenAgent.cs", "C#", 105, 0, 0, 25, 130
"/Users/kami/UnityProjects/Sweet-Bedtime-O-Mine/Assets/Scripts/Boss/FireBall.cs", "C#", 26, 0, 0, 6, 32
"/Users/kami/UnityProjects/Sweet-Bedtime-O-Mine/Assets/Scripts/Boss/FireBallDamage.cs", "C#", 13, 0, 1, 4, 18
"/Users/kami/UnityProjects/Sweet-Bedtime-O-Mine/Assets/Scripts/Boss/Flame.cs", "C#", 25, 0, 0, 5, 30
"/Users/kami/UnityProjects/Sweet-Bedtime-O-Mine/Assets/Scripts/Boss/SunAgent.cs", "C#", 59, 0, 0, 9, 68
"/Users/kami/UnityProjects/Sweet-Bedtime-O-Mine/Assets/Scripts/CircleTransition.shader", "ShaderLab", 0, 66, 0, 10, 76
"/Users/kami/UnityProjects/Sweet-Bedtime-O-Mine/Assets/Scripts/Dungeon/Door.cs", "C#", 18, 0, 0, 4, 22
"/Users/kami/UnityProjects/Sweet-Bedtime-O-Mine/Assets/Scripts/Dungeon/DungeonManager.cs", "C#", 233, 0, 8, 35, 276
"/Users/kami/UnityProjects/Sweet-Bedtime-O-Mine/Assets/Scripts/Dungeon/RandomDungeonGenerator.cs", "C#", 304, 0, 21, 28, 353
"/Users/kami/UnityProjects/Sweet-Bedtime-O-Mine/Assets/Scripts/Monsters/Clock/ClockAgent.cs", "C#", 81, 0, 0, 17, 98
"/Users/kami/UnityProjects/Sweet-Bedtime-O-Mine/Assets/Scripts/Monsters/Clock/ClockBullet.cs", "C#", 25, 0, 0, 6, 31
"/Users/kami/UnityProjects/Sweet-Bedtime-O-Mine/Assets/Scripts/Monsters/CollideDamage.cs", "C#", 15, 0, 0, 2, 17
"/Users/kami/UnityProjects/Sweet-Bedtime-O-Mine/Assets/Scripts/Monsters/DigitalClock/DigitalClockAgent.cs", "C#", 90, 0, 0, 17, 107
"/Users/kami/UnityProjects/Sweet-Bedtime-O-Mine/Assets/Scripts/Monsters/DigitalClock/DigitalClockProxy.cs", "C#", 72, 0, 1, 10, 83
"/Users/kami/UnityProjects/Sweet-Bedtime-O-Mine/Assets/Scripts/Monsters/DigitalClock/DigitalDamageReceiver.cs", "C#", 39, 0, 0, 8, 47
"/Users/kami/UnityProjects/Sweet-Bedtime-O-Mine/Assets/Scripts/Monsters/ElectricDrill/ElectricDrillAgent.cs", "C#", 112, 0, 1, 16, 129
"/Users/kami/UnityProjects/Sweet-Bedtime-O-Mine/Assets/Scripts/Monsters/ElectricDrill/ElectricDrillCollider.cs", "C#", 19, 0, 0, 4, 23
"/Users/kami/UnityProjects/Sweet-Bedtime-O-Mine/Assets/Scripts/Monsters/MonsterDamageReceiver.cs", "C#", 71, 0, 5, 7, 83
"/Users/kami/UnityProjects/Sweet-Bedtime-O-Mine/Assets/Scripts/Monsters/Monstergenerator.cs", "C#", 30, 0, 0, 8, 38
"/Users/kami/UnityProjects/Sweet-Bedtime-O-Mine/Assets/Scripts/Monsters/Pendulum/Explore.cs", "C#", 48, 0, 0, 11, 59
"/Users/kami/UnityProjects/Sweet-Bedtime-O-Mine/Assets/Scripts/Monsters/Pendulum/PendulumAgent.cs", "C#", 104, 0, 0, 23, 127
"/Users/kami/UnityProjects/Sweet-Bedtime-O-Mine/Assets/Scripts/Monsters/Trumpet/TrumpetAgent.cs", "C#", 119, 0, 0, 24, 143
"/Users/kami/UnityProjects/Sweet-Bedtime-O-Mine/Assets/Scripts/Monsters/Trumpet/TrumpetAttack.cs", "C#", 49, 0, 0, 12, 61
"/Users/kami/UnityProjects/Sweet-Bedtime-O-Mine/Assets/Scripts/Monsters/Trumpet/TrumpetAttackCircle.cs", "C#", 53, 0, 0, 11, 64
"/Users/kami/UnityProjects/Sweet-Bedtime-O-Mine/Assets/Scripts/Player/Attack.cs", "C#", 96, 0, 0, 5, 101
"/Users/kami/UnityProjects/Sweet-Bedtime-O-Mine/Assets/Scripts/Player/CameraFollow.cs", "C#", 20, 0, 2, 6, 28
"/Users/kami/UnityProjects/Sweet-Bedtime-O-Mine/Assets/Scripts/Player/PlayerBehavior.cs", "C#", 228, 0, 6, 18, 252
"/Users/kami/UnityProjects/Sweet-Bedtime-O-Mine/Assets/Scripts/Player/ProjectileBehavior.cs", "C#", 12, 0, 0, 3, 15
"/Users/kami/UnityProjects/Sweet-Bedtime-O-Mine/Assets/Scripts/UI/CircleTransition.cs", "C#", 82, 0, 3, 13, 98
"/Users/kami/UnityProjects/Sweet-Bedtime-O-Mine/Assets/Scripts/UI/EndUI.cs", "C#", 44, 0, 0, 10, 54
"/Users/kami/UnityProjects/Sweet-Bedtime-O-Mine/Assets/Scripts/UI/HintUI.cs", "C#", 25, 0, 0, 5, 30
"/Users/kami/UnityProjects/Sweet-Bedtime-O-Mine/Assets/Scripts/UI/PauseUI.cs", "C#", 48, 0, 0, 6, 54
"/Users/kami/UnityProjects/Sweet-Bedtime-O-Mine/Assets/Scripts/UI/PressButtonEffect.cs", "C#", 24, 0, 3, 3, 30
"/Users/kami/UnityProjects/Sweet-Bedtime-O-Mine/Assets/Scripts/UI/WelcomeUI.cs", "C#", 22, 0, 0, 5, 27
"Total", "-", 2442, 66, 55, 402, 2965